5x5* o12
**1**
*  **
*   *
*   *
**2**
