10x10* o12
***1****** (0, 3)
*  o    ** (1, 3)
* *o **  * (2, 3)
* oo     * (3, 3)(3, 2)
**o** ** * (4, 2)
* o     ** (5, 2)
* o    *** (6, 2)
**o      * (7, 2)
* oo     * (8, 2)(8, 3)
***2****** (9, 3)
10 STEPS!