13x15* o12
***1***********
**    *   *   *
*     * *     *
*   ***  *    *
*     * *  ** *
*          *  *
*      *    * *
*    *   ***  *
* *       *  **
*   *   *  *  *
* **  *  *    *
*    * *   *  *
***2***********
