20x24* o12
*****************1******
* *  *    *  * *       *
* *  *     **        * *
*   * *     *   * *   **
*       * *    **  * * *
*           ***   **   *
*     **    * * *   ** *
*      *   *     *     *
*    *     *        *  *
** * **       ****     *
*  * **      *     **  *
*     * *  * *** *   * *
*                  *   *
* *   *  *       *     *
*   **      **         *
*         *    *   *   *
*    *  * **    *      *
*   *                 **
*     *           *  * *
************2***********
